##############
#X#        # G
# # ######## #
# #     #    #
# ##### ### ##
#     # # #  #
### #   #    #
# # ##### ## #
# # # #   #  #
# # # ##### ##
#   #     #  #
###   ### ## #
# #####   #  #
#            #
##############
