###############
#M#        #  G
# # ######## ##
# #     #  #  #
# ##### ## # ##
#     #  #    #
### #   #  ## #
# # ##### ##  #
# # # #   # # #
# # # ##### # #
#   #     #   #
###   ### ### #
# ##### # # # #
#             #
###############
