###############
#M# #      #  G
# # # # #### ##
# #   # #  #  #
# ##### ## ## #
#     #  #    #
### #   #  ## #
# # ##### #   #
# # # #   # # #
# # # ##### ###
#   #     #   #
###   ### ### #
# ## ## # # # #
#    #        #
###############
