###############
#M# #      #  G
# # # #### # ##
# #   #    #  #
# ### # ##### #
#     # #     #
# # ### # ### #
# # # # # #   #
# # # #   # # #
# # # ##### ###
# # # #   #   #
###   ### ### #
# ## ## # # # #
#       #     #
###############
