###############
#M#        #  G
# # ######## ##
# #     #  #  #
# ##### ## # ##
#     # #     #
### #   #  #  #
# # ##### ##  #
# # # #   # # #
# # # ##### # #
#   #     #   #
###   ### ### #
# ##### # #   #
#             #
###############
