###############
#M# #      #  G
# # # # #### ##
# #   #    #  #
# ##### ##### #
#     #  #    #
### #   #  ## #
# # ### # #   #
# # # #   # # #
# # # ##### ###
#   #  #  #   #
###   ### ### #
# ## ## # # # #
#       #     #
###############
